NO ./path_to_the_north_texture
SO ./path_to_the_south_texture
WE ./path_to_the_west_texture
EA ./path_to_the_east_texture

F 200,100,0
C 225,30,0

111111111111
10000N000011               1
111111111111
