F 200,100,0
C 0,0,0

NO   ../bonus/textures/wall5.xpm
EA   ../bonus/textures/wall2.xpm
WE   ../bonus/textures/wall5.xpm
SO   ../bonus/textures/wall5.xpm

111111111111
10000N000001
111111111111

111
101
111