EA ./path_to_the_east_texture
NO ./path_to_the_north_texture
SO ./path_to_the_south_texture     
WE ./path_to_the_west_texture


F 220,100,0
C 225,30,0

11111111111111111111111111111111111111111111111111111111111111111111111111111111111111111
11000000000000000000000000000000000000000000000000000000000000000000000000000000000001001
10000000000111111111111111111000000000000000000001111111111111111111111110000000000001001
10000000000000000000000000000000000000000000000000000000000000000000000000000000000001001
10000000000000000000000000000000000000000000000001100000000001000000000000000000000001001
10000010100000000000000000000000000010000000000001100000000001000000000000000000000001001
10000010100000010000000000000000000010000000000001100000000001000000000000000010000001001
10000010100000000000000010000000000010000000000001100000000001000000000000000010000001001
10000010100000100000000010000000000010000000000001100000000001000000000000000010000001001
10000010100000100000000010000000000010000000000001100000000001000000000000000010000001001
10000010100000100000000010000000000010000000000001100000000001000000000000000010000000001
10000010100000100000000010000000000010000000000001100000000001000000000000000010000001001
10000010100000100000000010000000000010000000000001100000000001000000000000000010000001001
10000010100000100000000010000000000010000000000001100000000001000000000000000010000001001
10000010100000100000000010000000000010000000000001100000000001000000000000000010000001001
10000010100000100000000010000000000010000000000001100000000001000000000000000000000001001
10000010100000100000000010000000000010000000000001100000000001000000000000000000000001001
10000010100000100000000010000000000010000000000001100000000000000000000000000000000001001
10000010100000100000000010000000000000000000000001100000000000000000000000000000000001001
10000010100000100000000000000000000000000000000000000000000000000000000000000000000001001
100000101000001000000000000000000000000000000000N0000000000000000000000000000000000001001
10000010100000100000000000000111111111111111111111111110000010000000000000000000000001001
10000010100000100000000000000000000000000000000000000000000010000000000001000000000001001
10000010100000100000000000000010000000000000000000000000000010000000000001000000000001001
10000010100000100000000000000010000000000000000000000000000010000000000001000000000001001
10000010100000000000000000000010000000000000000000000000000010000000000001000000000001001
10000010100000000000000000000010000000000000000000000000000010000000000001000000000001001
10000010100000000000000000000010000000000000000010000000000010000000000001000000000001001
10000010100000000000000000000000000000000000000010000000000000000000000001000000000001001
10000010100000000000000000000000000000000000000010000000000000000000000001000000000001001
10000000000000000000000000000000000000000000000010000000000000000000000001000000000001001
10000000000000000000000000000000000000000000000010000000000000010000000001000000000000001
10000000000000000000000000000000000000000000000010000000000000010000000001000000000001001
10000000000000000000000000000000000000000000000010000000000000010000000001000000000001001
10001111111111111111111111111111111111111110000010000000000000010000000001000000000001001
10000000000000000000000000000000000000000000000010000000000000010000000001000000000001001
10000000000000000000000000000000000000000000000000000000000000010000000001000000000001001
10000000000000000000000000000000000000000000000000000000000000000000000000000000000001001
11111111111111111111111111111111111111111111111111111111111111111111111111111111111111111
