

NO ./path_to_the_north_texture
SO ./path_to_the_south_texture     
WE ./path_to_the_west_texture
EA ./path_to_the_east_texture

F 220,100,0
C 225,30,0

111111111111111111111111
100000000100000000000001
100001000D00010000000001
101000000111111111111D11
100000000000000000000001
1000000000000N0000000101
100000010000000000000001
1000000D0000000000000001
1000000D0000000000000011
111111111111111111111111